Pin | Role
----+------
1   | RESET
2   | OD0
3   | OD1
4   | OD2
5   | OD3
6   | OD4
7   | VCC
8   | GND
9   | PP6
10  | PP7
11  | OD5
12  | OD6
13  | OD7
14  | PP0
15  | PP1
16  | PP2
17  | PP3
18  | PP4
19  | PP5
20  | VCC
21  | INT
22  | GND
23  | AD0
24  | AD1
25  | N/C
26  | N/C
27  | SDA
28  | SCL
